2000000000
2000000000
0000000010
0030001000
0030000000
0030220004
0000000204
0000100204
0333000004
0000001000